REACTOME_GLYCOGEN_BREAKDOWN_GLYCOGENOLYSIS	Glycogen breakdown (glycogenolysis)	1
REACTOME_TRANSLATION	Translation	1
REACTOME_PYRIMIDINE_CATABOLISM	Pyrimidine catabolism	1
REACTOME_PYRUVATE_METABOLISM_AND_CITRIC_ACID_TCA_CYCLE	Pyruvate metabolism and Citric Acid (TCA) cycle	1
REACTOME_APOPTOTIC_CLEAVAGE_OF_CELLULAR_PROTEINS	Apoptotic cleavage of cellular proteins	1
REACTOME_FORMATION_OF_THE_TERNARY_COMPLEX_AND_SUBSEQUENTLY_THE_43S_COMPLEX	Formation of the ternary complex, and subsequently, the 43S complex	1
REACTOME_GAP_JUNCTION_DEGRADATION	Gap junction degradation	1
REACTOME_BASE_EXCISION_REPAIR	Base Excision Repair	1
REACTOME_BILE_ACID_AND_BILE_SALT_METABOLISM	Bile acid and bile salt metabolism	1
REACTOME_RECYCLING_OF_BILE_ACIDS_AND_SALTS	Recycling of bile acids and salts	1
REACTOME_SIGNALING_BY_RHO_GTPASES	Signaling by Rho GTPases	1
REACTOME_SIGNALING_BY_WNT	Signaling by Wnt	1
REACTOME_SYNTHESIS_OF_BILE_ACIDS_AND_BILE_SALTS	Synthesis of bile acids and bile salts	1
REACTOME_ANDROGEN_BIOSYNTHESIS	Androgen biosynthesis	1
REACTOME_INSULIN_RECEPTOR_RECYCLING	Insulin receptor recycling	1
REACTOME_NEF_MEDIATED_DOWNREGULATION_OF_MHC_CLASS_I_COMPLEX_CELL_SURFACE_EXPRESSION	Nef mediated downregulation of MHC class I complex cell surface expression	1
REACTOME_DEVELOPMENTAL_BIOLOGY	Developmental Biology	1
REACTOME_SIGNALING_BY_NODAL	Signaling by NODAL	1
REACTOME_DAG_AND_IP3_SIGNALING	DAG and IP3 signaling	1
REACTOME_SPRY_REGULATION_OF_FGF_SIGNALING	Spry regulation of FGF signaling	1
REACTOME_GROWTH_HORMONE_RECEPTOR_SIGNALING	Growth hormone receptor signaling	1
REACTOME_TETRAHYDROBIOPTERIN_BH4_SYNTHESIS_RECYCLING_SALVAGE_AND_REGULATION	Tetrahydrobiopterin (BH4) synthesis, recycling, salvage and regulation	1
REACTOME_MEIOSIS	Meiosis	1
REACTOME_G0_AND_EARLY_G1	G0 and Early G1	1
REACTOME_REGULATION_OF_KIT_SIGNALING	Regulation of KIT signaling	1
REACTOME_MEMBRANE_TRAFFICKING	Membrane Trafficking	1
REACTOME_VITAMIN_B5_PANTOTHENATE_METABOLISM	Vitamin B5 (pantothenate) metabolism	1
REACTOME_METABOLISM_OF_VITAMINS_AND_COFACTORS	Metabolism of vitamins and cofactors	1
REACTOME_CELL_CYCLE	Cell Cycle	1
REACTOME_SIGNALING_BY_ERBB4	Signaling by ERBB4	1
REACTOME_ORC1_REMOVAL_FROM_CHROMATIN	Orc1 removal from chromatin	1
REACTOME_SULFUR_AMINO_ACID_METABOLISM	Sulfur amino acid metabolism	1
REACTOME_PROLACTIN_RECEPTOR_SIGNALING	Prolactin receptor signaling	1
REACTOME_SIGNALING_BY_ERBB2	Signaling by ERBB2	1
REACTOME_SPHINGOLIPID_DE_NOVO_BIOSYNTHESIS	Sphingolipid de novo biosynthesis	1
REACTOME_DEFENSINS	Defensins	1
REACTOME_GRB2_EVENTS_IN_ERBB2_SIGNALING	GRB2 events in ERBB2 signaling	1
REACTOME_SIGNALING_BY_EGFR_IN_CANCER	Signaling by EGFR in Cancer	1
REACTOME_MEMBRANE_BINDING_AND_TARGETTING_OF_GAG_PROTEINS	Membrane binding and targetting of GAG proteins	1
REACTOME_BETA_DEFENSINS	Beta defensins	1
REACTOME_PI3K_EVENTS_IN_ERBB4_SIGNALING	PI3K events in ERBB4 signaling	1
REACTOME_SHC1_EVENTS_IN_ERBB4_SIGNALING	SHC1 events in ERBB4 signaling	1
REACTOME_PI3K_EVENTS_IN_ERBB2_SIGNALING	PI3K events in ERBB2 signaling	1
REACTOME_NUCLEAR_SIGNALING_BY_ERBB4	Nuclear signaling by ERBB4	1
REACTOME_GLYCOSPHINGOLIPID_METABOLISM	Glycosphingolipid metabolism	1
REACTOME_PPARA_ACTIVATES_GENE_EXPRESSION	PPARA activates gene expression	1
REACTOME_DEGRADATION_OF_THE_EXTRACELLULAR_MATRIX	Degradation of the extracellular matrix	1
REACTOME_MITOCHONDRIAL_PROTEIN_IMPORT	Mitochondrial protein import	1
REACTOME_SIGNALING_BY_HIPPO	Signaling by Hippo	1
REACTOME_ACTIVATED_NOTCH1_TRANSMITS_SIGNAL_TO_THE_NUCLEUS	Activated NOTCH1 Transmits Signal to the Nucleus	1
REACTOME_TRAFFICKING_AND_PROCESSING_OF_ENDOSOMAL_TLR	Trafficking and processing of endosomal TLR	1
REACTOME_SIGNALING_BY_NOTCH4	Signaling by NOTCH4	1
REACTOME_DOWNSTREAM_SIGNALING_EVENTS_OF_B_CELL_RECEPTOR_BCR	Downstream signaling events of B Cell Receptor (BCR)	1
REACTOME_REGULATION_OF_COMPLEMENT_CASCADE	Regulation of Complement cascade	1
REACTOME_SIGNALING_BY_NOTCH2	Signaling by NOTCH2	1
REACTOME_EXTRACELLULAR_MATRIX_ORGANIZATION	Extracellular matrix organization	1
REACTOME_NOTCH1_INTRACELLULAR_DOMAIN_REGULATES_TRANSCRIPTION	NOTCH1 Intracellular Domain Regulates Transcription	1
REACTOME_SIGNALING_BY_NOTCH1	Signaling by NOTCH1	1
REACTOME_SIGNALING_BY_NOTCH3	Signaling by NOTCH3	1
REACTOME_TRIGLYCERIDE_BIOSYNTHESIS	Triglyceride biosynthesis	1
REACTOME_INSULIN_RECEPTOR_SIGNALLING_CASCADE	Insulin receptor signalling cascade	1
REACTOME_PROLONGED_ERK_ACTIVATION_EVENTS	Prolonged ERK activation events	1
REACTOME_SIGNALLING_TO_RAS	Signalling to RAS	1
REACTOME_SIGNALING_BY_BMP	Signaling by BMP	1
REACTOME_CELL_SURFACE_INTERACTIONS_AT_THE_VASCULAR_WALL	Cell surface interactions at the vascular wall	1
REACTOME_NGF_SIGNALLING_VIA_TRKA_FROM_THE_PLASMA_MEMBRANE	NGF signalling via TRKA from the plasma membrane	1
REACTOME_SIGNALLING_TO_ERKS	Signalling to ERKs	1
REACTOME_P38MAPK_EVENTS	p38MAPK events	1
REACTOME_ACYL_CHAIN_REMODELLING_OF_PI	Acyl chain remodelling of PI	1
REACTOME_COLLAGEN_FORMATION	Collagen formation	1
REACTOME_SIGNALING_BY_FGFR_IN_DISEASE	Signaling by FGFR in disease	1
REACTOME_SYNTHESIS_OF_PIPS_AT_THE_EARLY_ENDOSOME_MEMBRANE	Synthesis of PIPs at the early endosome membrane	1
REACTOME_SIGNALLING_TO_P38_VIA_RIT_AND_RIN	Signalling to p38 via RIT and RIN	1
REACTOME_ACYL_CHAIN_REMODELLING_OF_PC	Acyl chain remodelling of PC	1
REACTOME_SYNTHESIS_OF_PIPS_AT_THE_GOLGI_MEMBRANE	Synthesis of PIPs at the Golgi membrane	1
REACTOME_ACTIVATED_POINT_MUTANTS_OF_FGFR2	Activated point mutants of FGFR2	1
REACTOME_PHOSPHOLIPID_METABOLISM	Phospholipid metabolism	1
REACTOME_SYNTHESIS_OF_PA	Synthesis of PA	1
REACTOME_SYNTHESIS_OF_PIPS_AT_THE_LATE_ENDOSOME_MEMBRANE	Synthesis of PIPs at the late endosome membrane	1
REACTOME_SYNTHESIS_OF_PE	Synthesis of PE	1
REACTOME_CHONDROITIN_SULFATE_BIOSYNTHESIS	Chondroitin sulfate biosynthesis	1
REACTOME_HYALURONAN_UPTAKE_AND_DEGRADATION	Hyaluronan uptake and degradation	1
REACTOME_SYNTHESIS_OF_PIPS_AT_THE_PLASMA_MEMBRANE	Synthesis of PIPs at the plasma membrane	1
REACTOME_THE_ACTIVATION_OF_ARYLSULFATASES	The activation of arylsulfatases	1
REACTOME_HYALURONAN_METABOLISM	Hyaluronan metabolism	1
REACTOME_KERATAN_SULFATE_BIOSYNTHESIS	Keratan sulfate biosynthesis	1
REACTOME_REVERSIBLE_HYDRATION_OF_CARBON_DIOXIDE	Reversible hydration of carbon dioxide	1
REACTOME_SIGNALING_BY_ACTIVATED_POINT_MUTANTS_OF_FGFR1	Signaling by activated point mutants of FGFR1	1
REACTOME_PI_METABOLISM	PI Metabolism	1
REACTOME_ABACAVIR_TRANSPORT_AND_METABOLISM	Abacavir transport and metabolism	1
REACTOME_LATENT_INFECTION_OF_HOMO_SAPIENS_WITH_MYCOBACTERIUM_TUBERCULOSIS	Latent infection of Homo sapiens with Mycobacterium tuberculosis	1
REACTOME_SYNTHESIS_OF_PC	Synthesis of PC	1
REACTOME_APOPTOSIS_INDUCED_DNA_FRAGMENTATION	Apoptosis induced DNA fragmentation	1
REACTOME_KERATAN_SULFATE_DEGRADATION	Keratan sulfate degradation	1
REACTOME_GLYCOSAMINOGLYCAN_METABOLISM	Glycosaminoglycan metabolism	1
REACTOME_ACYL_CHAIN_REMODELLING_OF_PG	Acyl chain remodelling of PG	1
REACTOME_ACYL_CHAIN_REMODELLING_OF_PE	Acyl chain remodelling of PE	1
REACTOME_ACYL_CHAIN_REMODELLING_OF_PS	Acyl chain remodelling of PS	1
REACTOME_MHC_CLASS_II_ANTIGEN_PRESENTATION	MHC class II antigen presentation	1
REACTOME_GLYCEROPHOSPHOLIPID_BIOSYNTHESIS	Glycerophospholipid biosynthesis	1
REACTOME_A_TETRASACCHARIDE_LINKER_SEQUENCE_IS_REQUIRED_FOR_GAG_SYNTHESIS	A tetrasaccharide linker sequence is required for GAG synthesis	1
REACTOME_PLATELET_ADHESION_TO_EXPOSED_COLLAGEN	Platelet Adhesion to exposed collagen	1
REACTOME_ENOS_ACTIVATION_AND_REGULATION	eNOS activation and regulation	1
REACTOME_MICRORNA_MIRNA_BIOGENESIS	MicroRNA (miRNA) biogenesis	1
REACTOME_NUCLEAR_EVENTS_KINASE_AND_TRANSCRIPTION_FACTOR_ACTIVATION	Nuclear Events (kinase and transcription factor activation)	1
REACTOME_RETROGRADE_NEUROTROPHIN_SIGNALLING	Retrograde neurotrophin signalling	1
REACTOME_ERKS_ARE_INACTIVATED	ERKs are inactivated	1
REACTOME_EGFR_DOWNREGULATION	EGFR downregulation	1
REACTOME_PECAM1_INTERACTIONS	PECAM1 interactions	1
REACTOME_TCR_SIGNALING	TCR signaling	1
REACTOME_REGULATION_OF_PYRUVATE_DEHYDROGENASE_PDH_COMPLEX	Regulation of pyruvate dehydrogenase (PDH) complex	1
REACTOME_DOWNSTREAM_TCR_SIGNALING	Downstream TCR signaling	1
REACTOME_BASIGIN_INTERACTIONS	Basigin interactions	1
REACTOME_AKT_PHOSPHORYLATES_TARGETS_IN_THE_CYTOSOL	AKT phosphorylates targets in the cytosol	1
REACTOME_GAB1_SIGNALOSOME	GAB1 signalosome	1
REACTOME_SHC1_EVENTS_IN_EGFR_SIGNALING	SHC1 events in EGFR signaling	1
REACTOME_PHOSPHORYLATION_OF_CD3_AND_TCR_ZETA_CHAINS	Phosphorylation of CD3 and TCR zeta chains	1
REACTOME_GLUTAMATE_NEUROTRANSMITTER_RELEASE_CYCLE	Glutamate Neurotransmitter Release Cycle	1
REACTOME_TIE2_SIGNALING	Tie2 Signaling	1
REACTOME_GENERATION_OF_SECOND_MESSENGER_MOLECULES	Generation of second messenger molecules	1
REACTOME_GENERIC_TRANSCRIPTION_PATHWAY	Generic Transcription Pathway	1
REACTOME_RESPONSE_TO_ELEVATED_PLATELET_CYTOSOLIC_CA2_	Response to elevated platelet cytosolic Ca2+	1
REACTOME_TRANSPORT_OF_MATURE_TRANSCRIPT_TO_CYTOPLASM	Transport of Mature Transcript to Cytoplasm	1
REACTOME_P75NTR_RECRUITS_SIGNALLING_COMPLEXES	p75NTR recruits signalling complexes	1
REACTOME_BIOLOGICAL_OXIDATIONS	Biological oxidations	1
REACTOME_REGULATED_PROTEOLYSIS_OF_P75NTR	Regulated proteolysis of p75NTR	1
REACTOME_TRANSMISSION_ACROSS_CHEMICAL_SYNAPSES	Transmission across Chemical Synapses	1
REACTOME_P75NTR_SIGNALS_VIA_NFKB	p75NTR signals via NF-kB	1
REACTOME_XENOBIOTICS	Xenobiotics	1
REACTOME_INTEGRIN_CELL_SURFACE_INTERACTIONS	Integrin cell surface interactions	1
REACTOME_REGULATION_OF_ORNITHINE_DECARBOXYLASE_ODC	Regulation of ornithine decarboxylase (ODC)	1
REACTOME_NRAGE_SIGNALS_DEATH_THROUGH_JNK	NRAGE signals death through JNK	1
REACTOME_NRIF_SIGNALS_CELL_DEATH_FROM_THE_NUCLEUS	NRIF signals cell death from the nucleus	1
REACTOME_REGULATION_OF_APOPTOSIS	Regulation of Apoptosis	1
REACTOME_NEURONAL_SYSTEM	Neuronal System	1
REACTOME_NFKB_IS_ACTIVATED_AND_SIGNALS_SURVIVAL	NF-kB is activated and signals survival	1
REACTOME_CELL_DEATH_SIGNALLING_VIA_NRAGE_NRIF_AND_NADE	Cell death signalling via NRAGE, NRIF and NADE	1
REACTOME_NEUROTRANSMITTER_RELEASE_CYCLE	Neurotransmitter release cycle	1
REACTOME_AMINO_ACID_TRANSPORT_ACROSS_THE_PLASMA_MEMBRANE	Amino acid transport across the plasma membrane	1
REACTOME_ENDOGENOUS_STEROLS	Endogenous sterols	1
REACTOME_REGULATION_OF_GENE_EXPRESSION_IN_BETA_CELLS	Regulation of gene expression in beta cells	1
REACTOME_GLYCOLYSIS	Glycolysis	1
REACTOME_PROCESSIVE_SYNTHESIS_ON_THE_LAGGING_STRAND	Processive synthesis on the lagging strand	1
REACTOME_PEPTIDE_CHAIN_ELONGATION	Peptide chain elongation	1
REACTOME_MRNA_CAPPING	mRNA Capping	1
REACTOME_SIGNALING_BY_GPCR	Signaling by GPCR	1
REACTOME_METABOLISM_OF_POLYAMINES	Metabolism of polyamines	1
REACTOME_INTEGRATION_OF_ENERGY_METABOLISM	Integration of energy metabolism	1
REACTOME_CELL_CYCLE_MITOTIC	Cell Cycle, Mitotic	1
REACTOME_GLUCONEOGENESIS	Gluconeogenesis	1
REACTOME_DOPAMINE_NEUROTRANSMITTER_RELEASE_CYCLE	Dopamine Neurotransmitter Release Cycle	1
REACTOME_OPIOID_SIGNALLING	Opioid Signalling	1
REACTOME_RECRUITMENT_OF_MITOTIC_CENTROSOME_PROTEINS_AND_COMPLEXES	Recruitment of mitotic centrosome proteins and complexes	1
REACTOME_MITOCHONDRIAL_TRNA_AMINOACYLATION	Mitochondrial tRNA aminoacylation	1
REACTOME_CYTOSOLIC_TRNA_AMINOACYLATION	Cytosolic tRNA aminoacylation	1
REACTOME_ACETYLCHOLINE_NEUROTRANSMITTER_RELEASE_CYCLE	Acetylcholine Neurotransmitter Release Cycle	1
REACTOME_ADENYLATE_CYCLASE_ACTIVATING_PATHWAY	Adenylate cyclase activating pathway	1
REACTOME_ADENYLATE_CYCLASE_INHIBITORY_PATHWAY	Adenylate cyclase inhibitory pathway	1
REACTOME_CHEMOKINE_RECEPTORS_BIND_CHEMOKINES	Chemokine receptors bind chemokines	1
REACTOME_LOSS_OF_NLP_FROM_MITOTIC_CENTROSOMES	Loss of Nlp from mitotic centrosomes	1
REACTOME_CELL_CYCLE_CHECKPOINTS	Cell Cycle Checkpoints	1
REACTOME_P130CAS_LINKAGE_TO_MAPK_SIGNALING_FOR_INTEGRINS	p130Cas linkage to MAPK signaling for integrins	1
REACTOME_GLYCOPROTEIN_HORMONES	Glycoprotein hormones	1
REACTOME_NOREPINEPHRINE_NEUROTRANSMITTER_RELEASE_CYCLE	Norepinephrine Neurotransmitter Release Cycle	1
REACTOME_PLC_BETA_MEDIATED_EVENTS	PLC beta mediated events	1
REACTOME_PEPTIDE_HORMONE_BIOSYNTHESIS	Peptide hormone biosynthesis	1
REACTOME_ACETYLCHOLINE_BINDING_AND_DOWNSTREAM_EVENTS	Acetylcholine binding and downstream events	1
REACTOME_TRNA_AMINOACYLATION	tRNA Aminoacylation	1
REACTOME_OLFACTORY_SIGNALING_PATHWAY	Olfactory Signaling Pathway	1
REACTOME_STEROID_HORMONES	Steroid hormones	1
REACTOME_RECRUITMENT_OF_NUMA_TO_MITOTIC_CENTROSOMES	Recruitment of NuMA to mitotic centrosomes	1
REACTOME_INTEGRIN_ALPHAIIB_BETA3_SIGNALING	Integrin alphaIIb beta3 signaling	1
REACTOME_NUCLEAR_RECEPTOR_TRANSCRIPTION_PATHWAY	Nuclear Receptor transcription pathway	1
REACTOME_G1_PHASE	G1 Phase	1
REACTOME_ELEVATION_OF_CYTOSOLIC_CA2_LEVELS	Elevation of cytosolic Ca2+ levels	1
REACTOME_GLUCAGON_SIGNALING_IN_METABOLIC_REGULATION	Glucagon signaling in metabolic regulation	1
REACTOME_SIGNALING_BY_PDGF	Signaling by PDGF	1
REACTOME_PROTEIN_FOLDING	Protein folding	1
REACTOME_PEROXISOMAL_LIPID_METABOLISM	Peroxisomal lipid metabolism	1
REACTOME_STRIATED_MUSCLE_CONTRACTION	Striated Muscle Contraction	1
REACTOME_METABOLISM_OF_PROTEINS	Metabolism of proteins	1
REACTOME_DOWNSTREAM_SIGNAL_TRANSDUCTION	Downstream signal transduction	1
REACTOME_MUSCLE_CONTRACTION	Muscle contraction	1
REACTOME_MRNA_SPLICING	mRNA Splicing	1
REACTOME_PURINE_RIBONUCLEOSIDE_MONOPHOSPHATE_BIOSYNTHESIS	Purine ribonucleoside monophosphate biosynthesis	1
REACTOME_CITRIC_ACID_CYCLE_TCA_CYCLE	Citric acid cycle (TCA cycle)	1
REACTOME_NUCLEOTIDE_EXCISION_REPAIR	Nucleotide Excision Repair	1
REACTOME_AXON_GUIDANCE	Axon guidance	1
REACTOME_G_ALPHA_Q_SIGNALLING_EVENTS	G alpha (q) signalling events	1
REACTOME_TRAFFICKING_OF_AMPA_RECEPTORS	Trafficking of AMPA receptors	1
REACTOME_NCAM1_INTERACTIONS	NCAM1 interactions	1
REACTOME_REGULATION_OF_INSULIN_SECRETION	Regulation of insulin secretion	1
REACTOME_TRANSPORT_OF_MATURE_MRNA_DERIVED_FROM_AN_INTRONLESS_TRANSCRIPT	Transport of Mature mRNA Derived from an Intronless Transcript	1
REACTOME_FANCONI_ANEMIA_PATHWAY	Fanconi Anemia Pathway	1
REACTOME_FORMATION_OF_RNA_POL_II_ELONGATION_COMPLEX_	Formation of RNA Pol II elongation complex	1
REACTOME_ELONGATION_ARREST_AND_RECOVERY	Elongation arrest and recovery	1
REACTOME_GPCR_DOWNSTREAM_SIGNALING	GPCR downstream signaling	1
REACTOME_SYNTHESIS_SECRETION_AND_DEACYLATION_OF_GHRELIN	Synthesis, secretion, and deacylation of Ghrelin	1
REACTOME_ADHERENS_JUNCTIONS_INTERACTIONS	Adherens junctions interactions	1
REACTOME_CRMPS_IN_SEMA3A_SIGNALING	CRMPs in Sema3A signaling	1
REACTOME_OTHER_SEMAPHORIN_INTERACTIONS	Other semaphorin interactions	1
REACTOME_ACTIVATION_OF_RAC	Activation of Rac	1
REACTOME_PURINE_SALVAGE	Purine salvage	1
REACTOME_G_ALPHA_I_SIGNALLING_EVENTS	G alpha (i) signalling events	1
REACTOME_SEMA3A_PAK_DEPENDENT_AXON_REPULSION	Sema3A PAK dependent Axon repulsion	1
REACTOME_CD28_DEPENDENT_VAV1_PATHWAY	CD28 dependent Vav1 pathway	1
REACTOME_SEMA4D_IN_SEMAPHORIN_SIGNALING	Sema4D in semaphorin signaling	1
REACTOME_SEMAPHORIN_INTERACTIONS	Semaphorin interactions	1
REACTOME_LYSOSOME_VESICLE_BIOGENESIS	Lysosome Vesicle Biogenesis	1
REACTOME_TRANSPORT_OF_GLUCOSE_AND_OTHER_SUGARS_BILE_SALTS_AND_ORGANIC_ACIDS_METAL_IONS_AND_AMINE_COMPOUNDS	Transport of glucose and other sugars, bile salts and organic acids, metal ions and amine compounds	1
REACTOME_SPHINGOLIPID_METABOLISM	Sphingolipid metabolism	1
REACTOME_PD1_SIGNALING	PD-1 signaling	1
REACTOME_G_ALPHA_S_SIGNALLING_EVENTS	G alpha (s) signalling events	1
REACTOME_CELL_CELL_JUNCTION_ORGANIZATION	Cell junction organization	1
REACTOME_G_ALPHA_Z_SIGNALLING_EVENTS	G alpha (z) signalling events	1
REACTOME_COSTIMULATION_BY_THE_CD28_FAMILY	Costimulation by the CD28 family	1
REACTOME_SIGNALING_BY_ROBO_RECEPTOR	Signaling by Robo receptor	1
REACTOME_TIGHT_JUNCTION_INTERACTIONS	Tight junction interactions	1
REACTOME_GOLGI_ASSOCIATED_VESICLE_BIOGENESIS	Golgi Associated Vesicle Biogenesis	1
REACTOME_CTLA4_INHIBITORY_SIGNALING	CTLA4 inhibitory signaling	1
REACTOME_AMINO_ACID_AND_OLIGOPEPTIDE_SLC_TRANSPORTERS	Amino acid and oligopeptide SLC transporters	1
REACTOME_SYNTHESIS_OF_DNA	Synthesis of DNA	1
REACTOME_FORMATION_OF_FIBRIN_CLOT_CLOTTING_CASCADE	Formation of Fibrin Clot (Clotting Cascade)	1
REACTOME_DEADENYLATION_OF_MRNA	Deadenylation of mRNA	1
REACTOME_MRNA_DECAY_BY_5_TO_3_EXORIBONUCLEASE	mRNA decay by 5' to 3' exoribonuclease	1
REACTOME_SIGNAL_AMPLIFICATION	Signal amplification	1
REACTOME_ZINC_TRANSPORTERS	Zinc transporters	1
REACTOME_RAS_ACTIVATION_UOPN_CA2_INFUX_THROUGH_NMDA_RECEPTOR	Ras activation uopn Ca2+ infux through NMDA receptor	1
REACTOME_METAL_ION_SLC_TRANSPORTERS	Metal ion SLC transporters	1
REACTOME_AUTODEGRADATION_OF_THE_E3_UBIQUITIN_LIGASE_COP1	Autodegradation of the E3 ubiquitin ligase COP1	1
REACTOME_SMOOTH_MUSCLE_CONTRACTION	Smooth Muscle Contraction	1
REACTOME_CREB_PHOSPHORYLATION_THROUGH_THE_ACTIVATION_OF_RAS	CREB phosphorylation through the activation of Ras	1
REACTOME_POST_NMDA_RECEPTOR_ACTIVATION_EVENTS	Post NMDA receptor activation events	1
REACTOME_UNBLOCKING_OF_NMDA_RECEPTOR_GLUTAMATE_BINDING_AND_ACTIVATION	Unblocking of NMDA receptor, glutamate binding and activation	1
REACTOME_MRNA_DECAY_BY_3_TO_5_EXORIBONUCLEASE	mRNA decay by 3' to 5' exoribonuclease	1
REACTOME_BILE_SALT_AND_ORGANIC_ANION_SLC_TRANSPORTERS	Bile salt and organic anion SLC transporters	1
REACTOME_CREB_PHOSPHORYLATION_THROUGH_THE_ACTIVATION_OF_CAMKII	CREB phosphorylation through the activation of CaMKII	1
REACTOME_THROMBOXANE_SIGNALLING_THROUGH_TP_RECEPTOR	Thromboxane signalling through TP receptor	1
REACTOME_CELL_JUNCTION_ORGANIZATION	Cell junction organization	1
REACTOME_AMINE_COMPOUND_SLC_TRANSPORTERS	Amine compound SLC transporters	1
REACTOME_PYRUVATE_METABOLISM	Pyruvate metabolism	1
REACTOME_PURINE_CATABOLISM	Purine catabolism	1
REACTOME_GLUCOSE_TRANSPORT	Glucose transport	1
REACTOME_METABOLISM_OF_RNA	Metabolism of RNA	1
REACTOME_REGULATION_OF_MITOTIC_CELL_CYCLE	Regulation of mitotic cell cycle	1
REACTOME_TAK1_ACTIVATES_NFKB_BY_PHOSPHORYLATION_AND_ACTIVATION_OF_IKKS_COMPLEX	TAK1 activates NFkB by phosphorylation and activation of IKKs complex	1
REACTOME_MYOGENESIS	Myogenesis	1
REACTOME_MAP_KINASE_ACTIVATION_IN_TLR_CASCADE	MAP kinase activation in TLR cascade	1
REACTOME_ACTIVATION_OF_KAINATE_RECEPTORS_UPON_GLUTAMATE_BINDING	Activation of kainate receptors upon glutamate binding	1
REACTOME_IONOTROPIC_ACTIVITY_OF_KAINATE_RECEPTORS	Ionotropic activity of kainate receptors	1
REACTOME_ACTIVATION_OF_THE_AP1_FAMILY_OF_TRANSCRIPTION_FACTORS	Activation of the AP-1 family of transcription factors	1
REACTOME_MAPK_TARGETS_NUCLEAR_EVENTS_MEDIATED_BY_MAP_KINASES	MAPK targets/ Nuclear events mediated by MAP kinases	1
REACTOME_GPCR_LIGAND_BINDING	GPCR ligand binding	1
REACTOME_THROMBIN_SIGNALLING_THROUGH_PROTEINASE_ACTIVATED_RECEPTORS_PARS	Thrombin signalling through proteinase activated receptors (PARs)	1
REACTOME_ACTIVATED_TAK1_MEDIATES_P38_MAPK_ACTIVATION	activated TAK1 mediates p38 MAPK activation	1
REACTOME_DNA_REPAIR	DNA Repair	1
REACTOME_EFFECTS_OF_PIP2_HYDROLYSIS	Effects of PIP2 hydrolysis	1
REACTOME_CHROMOSOME_MAINTENANCE	Chromosome Maintenance	1
REACTOME_L1CAM_INTERACTIONS	L1CAM interactions	1
REACTOME_ROLE_OF_SECOND_MESSENGERS_IN_NETRIN1_SIGNALING	Role of second messengers in netrin-1 signaling	1
REACTOME_NETRIN1_SIGNALING	Netrin-1 signaling	1
REACTOME_INTERACTION_BETWEEN_L1_AND_ANKYRINS	Interaction between L1 and Ankyrins	1
REACTOME_SIGNAL_TRANSDUCTION_BY_L1	Signal transduction by L1	1
REACTOME_TRANSPORT_OF_VITAMINS_NUCLEOSIDES_AND_RELATED_MOLECULES	Transport of vitamins, nucleosides, and related molecules	1
REACTOME_HIGHLY_CALCIUM_PERMEABLE_POSTSYNAPTIC_NICOTINIC_ACETYLCHOLINE_RECEPTORS	Highly calcium permeable postsynaptic nicotinic acetylcholine receptors	1
REACTOME_PRESYNAPTIC_NICOTINIC_ACETYLCHOLINE_RECEPTORS	Presynaptic nicotinic acetylcholine receptors	1
REACTOME_DCC_MEDIATED_ATTRACTIVE_SIGNALING	DCC mediated attractive signaling	1
REACTOME_RECYCLING_PATHWAY_OF_L1	Recycling pathway of L1	1
REACTOME_RESPIRATORY_ELECTRON_TRANSPORT	Respiratory electron transport	1
REACTOME_CGMP_EFFECTS	cGMP effects	1
REACTOME_REGULATION_OF_SIGNALING_BY_CBL	Regulation of signaling by CBL	1
REACTOME_AMINO_ACID_SYNTHESIS_AND_INTERCONVERSION_TRANSAMINATION	Amino acid synthesis and interconversion (transamination)	1
REACTOME_NEPHRIN_INTERACTIONS	Nephrin interactions	1
REACTOME_NITRIC_OXIDE_STIMULATES_GUANYLATE_CYCLASE	Nitric oxide stimulates guanylate cyclase	1
REACTOME_PLATELET_HOMEOSTASIS	Platelet homeostasis	1
REACTOME_PLATELET_SENSITIZATION_BY_LDL	Platelet sensitization by LDL	1
REACTOME_RAP1_SIGNALLING	Rap1 signalling	1
REACTOME_PLATELET_CALCIUM_HOMEOSTASIS	Platelet calcium homeostasis	1
REACTOME_SIGNAL_REGULATORY_PROTEIN_SIRP_FAMILY_INTERACTIONS	Signal regulatory protein (SIRP) family interactions	1
REACTOME_PROSTACYCLIN_SIGNALLING_THROUGH_PROSTACYCLIN_RECEPTOR	Prostacyclin signalling through prostacyclin receptor	1
REACTOME_GABA_SYNTHESIS_RELEASE_REUPTAKE_AND_DEGRADATION	GABA synthesis, release, reuptake and degradation	1
REACTOME_INCRETIN_SYNTHESIS_SECRETION_AND_INACTIVATION	Incretin synthesis, secretion, and inactivation	1
REACTOME_TRANSPORT_OF_ORGANIC_ANIONS	Transport of organic anions	1
REACTOME_IRAK1_RECRUITS_IKK_COMPLEX	IRAK1 recruits IKK complex	1
REACTOME_TRAF6_MEDIATED_IRF7_ACTIVATION	TRAF6 mediated IRF7 activation	1
REACTOME_CIRCADIAN_CLOCK	Circadian Clock	1
REACTOME_TRAF6_MEDIATED_NFKB_ACTIVATION	TRAF6 mediated NF-kB activation	1
REACTOME_FACTORS_INVOLVED_IN_MEGAKARYOCYTE_DEVELOPMENT_AND_PLATELET_PRODUCTION	Factors involved in megakaryocyte development and platelet production	1
REACTOME_REGULATION_OF_IFNG_SIGNALING	Regulation of IFNG signaling	1
REACTOME_GABA_A_RECEPTOR_ACTIVATION	GABA A receptor activation	1
REACTOME_GABA_B_RECEPTOR_ACTIVATION	GABA B receptor activation	1
REACTOME_TRANSPORT_TO_THE_GOLGI_AND_SUBSEQUENT_MODIFICATION	Transport to the Golgi and subsequent modification	1
REACTOME_IRON_UPTAKE_AND_TRANSPORT	Iron uptake and transport	1
REACTOME_INTERFERON_GAMMA_SIGNALING	Interferon gamma signaling	1
REACTOME_ADVANCED_GLYCOSYLATION_ENDPRODUCT_RECEPTOR_SIGNALING	Advanced glycosylation endproduct receptor signaling	1
REACTOME_GABA_RECEPTOR_ACTIVATION	GABA receptor activation	1
REACTOME_KINESINS	Kinesins	1
REACTOME_REGULATION_OF_IFNA_SIGNALING	Regulation of IFNA signaling	1
REACTOME_INTERFERON_SIGNALING	Interferon Signaling	1
REACTOME_TRANSFERRIN_ENDOCYTOSIS_AND_RECYCLING	Transferrin endocytosis and recycling	1
REACTOME_DSCAM_INTERACTIONS	DSCAM interactions	1
REACTOME_ION_CHANNEL_TRANSPORT	Ion channel transport	1
REACTOME_TRAF6_MEDIATED_INDUCTION_OF_TAK1_COMPLEX	TRAF6 mediated induction of TAK1 complex	1
REACTOME_IKK_COMPLEX_RECRUITMENT_MEDIATED_BY_RIP1	IKK complex recruitment mediated by RIP1	1
REACTOME_TRANSCRIPTIONAL_REGULATION_OF_WHITE_ADIPOCYTE_DIFFERENTIATION	Transcriptional regulation of white adipocyte differentiation	1
REACTOME_ENDOSOMAL_SORTING_COMPLEX_REQUIRED_FOR_TRANSPORT_ESCRT	Endosomal Sorting Complex Required For Transport (ESCRT)	1
REACTOME_MEIOTIC_RECOMBINATION	Meiotic recombination	1
REACTOME_PLATELET_AGGREGATION_PLUG_FORMATION	Platelet Aggregation (Plug Formation)	1
REACTOME_SIGNALING_BY_NOTCH	Signaling by NOTCH	1
REACTOME_LAGGING_STRAND_SYNTHESIS	Lagging Strand Synthesis	1
REACTOME_ETHANOL_OXIDATION	Ethanol oxidation	1
REACTOME_DNA_REPLICATION	DNA Replication	1
REACTOME_CLEAVAGE_OF_GROWING_TRANSCRIPT_IN_THE_TERMINATION_REGION_	Cleavage of Growing Transcript in the Termination Region	1
REACTOME_E2F_MEDIATED_REGULATION_OF_DNA_REPLICATION	E2F mediated regulation of DNA replication	1
REACTOME_SIGNALING_BY_INSULIN_RECEPTOR	Signaling by Insulin receptor	1
REACTOME_SIGNAL_ATTENUATION	Signal attenuation	1
REACTOME_APOPTOSIS	Apoptosis	1
REACTOME_HEMOSTASIS	Hemostasis	1
REACTOME_INFLUENZA_LIFE_CYCLE	Influenza Life Cycle	1
REACTOME_INFLUENZA_VIRAL_RNA_TRANSCRIPTION_AND_REPLICATION	Influenza Viral RNA Transcription and Replication	1
REACTOME_HIV_INFECTION	HIV Infection	1
REACTOME_TRANSPORT_OF_RIBONUCLEOPROTEINS_INTO_THE_HOST_NUCLEUS	Transport of Ribonucleoproteins into the Host Nucleus	1
REACTOME_HIV_LIFE_CYCLE	HIV Life Cycle	1
REACTOME_ABORTIVE_ELONGATION_OF_HIV1_TRANSCRIPT_IN_THE_ABSENCE_OF_TAT	Abortive elongation of HIV-1 transcript in the absence of Tat	1
REACTOME_EARLY_PHASE_OF_HIV_LIFE_CYCLE	Early Phase of HIV Life Cycle	1
REACTOME_HOST_INTERACTIONS_OF_HIV_FACTORS	Host Interactions of HIV factors	1
REACTOME_RESPIRATORY_ELECTRON_TRANSPORT_ATP_SYNTHESIS_BY_CHEMIOSMOTIC_COUPLING_AND_HEAT_PRODUCTION_BY_UNCOUPLING_PROTEINS_	Respiratory electron transport, ATP synthesis by chemiosmotic coupling, and heat production by uncoupling proteins.	1
REACTOME_FORMATION_OF_THE_HIV1_EARLY_ELONGATION_COMPLEX	Formation of the HIV-1 Early Elongation Complex	1
REACTOME_VIRAL_MESSENGER_RNA_SYNTHESIS	Viral Messenger RNA Synthesis	1
REACTOME_LATE_PHASE_OF_HIV_LIFE_CYCLE	Late Phase of HIV Life Cycle	1
REACTOME_INTERACTIONS_OF_VPR_WITH_HOST_CELLULAR_PROTEINS	Interactions of Vpr with host cellular proteins	1
REACTOME_FORMATION_OF_ATP_BY_CHEMIOSMOTIC_COUPLING	Formation of ATP by chemiosmotic coupling	1
REACTOME_ACTIVATION_OF_ATR_IN_RESPONSE_TO_REPLICATION_STRESS	Activation of ATR in response to replication stress	1
REACTOME_UNWINDING_OF_DNA	Unwinding of DNA	1
REACTOME_GLUCURONIDATION	Glucuronidation	1
REACTOME_INNATE_IMMUNE_SYSTEM	Innate Immune System	1
REACTOME_REGULATION_OF_GLUCOKINASE_BY_GLUCOKINASE_REGULATORY_PROTEIN	Regulation of Glucokinase by Glucokinase Regulatory Protein	1
REACTOME_MITOTIC_PROMETAPHASE	Mitotic Prometaphase	1
REACTOME_LIPOPROTEIN_METABOLISM	Lipoprotein metabolism	1
REACTOME_THE_ROLE_OF_NEF_IN_HIV1_REPLICATION_AND_DISEASE_PATHOGENESIS	The role of Nef in HIV-1 replication and disease pathogenesis	1
REACTOME_ACTIVATED_TLR4_SIGNALLING	Activated TLR4 signalling	1
REACTOME_IMMUNE_SYSTEM	Immune System	1
REACTOME_BINDING_AND_ENTRY_OF_HIV_VIRION	Binding and entry of HIV virion	1
REACTOME_CYTOSOLIC_SULFONATION_OF_SMALL_MOLECULES	Cytosolic sulfonation of small molecules	1
REACTOME_INTEGRATION_OF_PROVIRUS	Integration of provirus	1
REACTOME_GLUTATHIONE_CONJUGATION	Glutathione conjugation	1
REACTOME_COMPLEMENT_CASCADE	Complement cascade	1
REACTOME_GLUCOSE_METABOLISM	Glucose metabolism	1
REACTOME_VOLTAGE_GATED_POTASSIUM_CHANNELS	Voltage gated Potassium channels	1
REACTOME_ADAPTIVE_IMMUNE_SYSTEM	Adaptive Immune System	1
REACTOME_CYTOKINE_SIGNALING_IN_IMMUNE_SYSTEM	Cytokine Signaling in Immune system	1
REACTOME_MEIOTIC_SYNAPSIS	Meiotic synapsis	1
REACTOME_ANTIGEN_PRESENTATION_FOLDING_ASSEMBLY_AND_PEPTIDE_LOADING_OF_CLASS_I_MHC	Antigen Presentation: Folding, assembly and peptide loading of class I MHC	1
REACTOME_THE_NLRP3_INFLAMMASOME	The NLRP3 inflammasome	1
REACTOME_TANDEM_PORE_DOMAIN_POTASSIUM_CHANNELS	Tandem pore domain potassium channels	1
REACTOME_INFLAMMASOMES	Inflammasomes	1
REACTOME_POTASSIUM_CHANNELS	Potassium Channels	1
REACTOME_INWARDLY_RECTIFYING_K_CHANNELS	Inwardly rectifying K+ channels	1
REACTOME_PACKAGING_OF_TELOMERE_ENDS	Packaging Of Telomere Ends	1
REACTOME_TELOMERE_MAINTENANCE	Telomere Maintenance	1
REACTOME_PLATELET_ACTIVATION_SIGNALING_AND_AGGREGATION	Platelet activation, signaling and aggregation	1
REACTOME_CREATION_OF_C4_AND_C2_ACTIVATORS	Creation of C4 and C2 activators	1
REACTOME_INITIAL_TRIGGERING_OF_COMPLEMENT	Initial triggering of complement	1
REACTOME_EXTENSION_OF_TELOMERES	Extension of Telomeres	1
REACTOME_S_PHASE	S Phase	1
REACTOME_TRYPTOPHAN_CATABOLISM	Tryptophan catabolism	1
REACTOME_DNA_STRAND_ELONGATION	DNA strand elongation	1
REACTOME_CHOLESTEROL_BIOSYNTHESIS	Cholesterol biosynthesis	1
REACTOME_APOBEC3G_MEDIATED_RESISTANCE_TO_HIV1_INFECTION	APOBEC3G mediated resistance to HIV-1 infection	1
REACTOME_GAP_JUNCTION_TRAFFICKING	Gap junction trafficking	1
REACTOME_FGFR2C_LIGAND_BINDING_AND_ACTIVATION	FGFR2c ligand binding and activation	1
REACTOME_FGFR4_LIGAND_BINDING_AND_ACTIVATION	FGFR4 ligand binding and activation	1
REACTOME_SIGNALING_BY_FGFR	Signaling by FGFR	1
REACTOME_DIGESTION_OF_DIETARY_CARBOHYDRATE	Digestion of dietary carbohydrate	1
REACTOME_FGFR1_LIGAND_BINDING_AND_ACTIVATION	FGFR1 ligand binding and activation	1
REACTOME_GAP_JUNCTION_ASSEMBLY	Gap junction assembly	1
REACTOME_SYNTHESIS_OF_GLYCOSYLPHOSPHATIDYLINOSITOL_GPI	Synthesis of glycosylphosphatidylinositol (GPI)	1
REACTOME_INTRINSIC_PATHWAY_FOR_APOPTOSIS	Intrinsic Pathway for Apoptosis	1
REACTOME_PI3K_CASCADE	PI3K Cascade	1
REACTOME_ANTIGEN_ACTIVATES_B_CELL_RECEPTOR_LEADING_TO_GENERATION_OF_SECOND_MESSENGERS	Antigen activates B Cell Receptor (BCR) leading to generation of second messengers	0.9166666667
REACTOME_RESOLUTION_OF_AP_SITES_VIA_THE_SINGLE_NUCLEOTIDE_REPLACEMENT_PATHWAY	APEX1-Independent Resolution of AP Sites via the Single Nucleotide Replacement Pathway	0.9090909091
REACTOME_PTM_GAMMA_CARBOXYLATION_HYPUSINE_FORMATION_AND_ARYLSULFATASE_ACTIVATION	Gamma carboxylation, hypusine formation and arylsulfatase activation	0.875
REACTOME_CLASS_I_MHC_MEDIATED_ANTIGEN_PROCESSING_PRESENTATION	Class I MHC mediated antigen processing & presentation	0.875
REACTOME_ACTIVATION_OF_THE_MRNA_UPON_BINDING_OF_THE_CAP_BINDING_COMPLEX_AND_EIFS_AND_SUBSEQUENT_BINDING_TO_43S	Activation of the mRNA upon binding of the cap-binding complex and eIFs, and subsequent binding to 43S	0.8571428571
REACTOME_CYTOCHROME_P450_ARRANGED_BY_SUBSTRATE_TYPE	Cytochrome P450 - arranged by substrate type	0.8571428571
REACTOME_APOPTOTIC_CLEAVAGE_OF_CELL_ADHESION_PROTEINS	Apoptotic cleavage of cell adhesion  proteins	0.8571428571
REACTOME_SYNTHESIS_AND_INTERCONVERSION_OF_NUCLEOTIDE_DI_AND_TRIPHOSPHATES	Interconversion of nucleotide di- and triphosphates	0.8571428571
REACTOME_MYD88_MAL_CASCADE_INITIATED_ON_PLASMA_MEMBRANE	MyD88 cascade initiated on plasma membrane	0.8571428571
REACTOME_SIGNALING_BY_FGFR1_FUSION_MUTANTS	Signaling by cytosolic FGFR1 fusion mutants	0.8333333333
REACTOME_ANTIGEN_PROCESSING_UBIQUITINATION_PROTEASOME_DEGRADATION	Antigen processing: Ubiquitination & Proteasome degradation	0.8333333333
REACTOME_INHIBITION_OF_THE_PROTEOLYTIC_ACTIVITY_OF_APC_C_REQUIRED_FOR_THE_ONSET_OF_ANAPHASE_BY_MITOTIC_SPINDLE_CHECKPOINT_COMPONENTS	Inhibition of the proteolytic activity of APC/C required for the onset of anaphase by mitotic spindle checkpoint components	0.8235294118
REACTOME_RECEPTOR_LIGAND_BINDING_INITIATES_THE_SECOND_PROTEOLYTIC_CLEAVAGE_OF_NOTCH_RECEPTOR	Receptor-ligand binding initiates the second proteolytic cleavage of Notch receptor	0.8181818182
REACTOME_NONSENSE_MEDIATED_DECAY_ENHANCED_BY_THE_EXON_JUNCTION_COMPLEX	Nonsense Mediated Decay (NMD) enhanced by the Exon Junction Complex (EJC)	0.8181818182
REACTOME_RNA_POL_III_TRANSCRIPTION_INITIATION_FROM_TYPE_2_PROMOTER	RNA Polymerase III Transcription Initiation From Type 2 Promoter	0.8
REACTOME_NEF_MEDIATES_DOWN_MODULATION_OF_CELL_SURFACE_RECEPTORS_BY_RECRUITING_THEM_TO_CLATHRIN_ADAPTERS	Nef-mediates down modulation of cell surface receptors by recruiting them to clathrin adapters	0.8
REACTOME_DOWNREGULATION_OF_ERBB2_ERBB3_SIGNALING	Downregulation of ERBB2 signaling	0.8
REACTOME_TRANSMEMBRANE_TRANSPORT_OF_SMALL_MOLECULES	Transport of small molecules	0.8
REACTOME_TRAF6_MEDIATED_INDUCTION_OF_NFKB_AND_MAP_KINASES_UPON_TLR7_8_OR_9_ACTIVATION	TRAF6 mediated induction of NFkB and MAP kinases upon TLR7/8 or 9 activation	0.8
REACTOME_RNA_POL_III_TRANSCRIPTION_INITIATION_FROM_TYPE_3_PROMOTER	RNA Polymerase III Transcription Initiation From Type 3 Promoter	0.8
REACTOME_IMMUNOREGULATORY_INTERACTIONS_BETWEEN_A_LYMPHOID_AND_A_NON_LYMPHOID_CELL	Immunoregulatory interactions between a Lymphoid and a non-Lymphoid cell	0.7777777778
REACTOME_IRAK2_MEDIATED_ACTIVATION_OF_TAK1_COMPLEX_UPON_TLR7_8_OR_9_STIMULATION	IRAK2 mediated activation of TAK1 complex upon TLR7/8 or 9 stimulation	0.7692307692
REACTOME_RESOLUTION_OF_AP_SITES_VIA_THE_MULTIPLE_NUCLEOTIDE_PATCH_REPLACEMENT_PATHWAY	Resolution of AP sites via the multiple-nucleotide patch replacement pathway	0.75
REACTOME_SIGNALING_BY_FGFR1_MUTANTS	FGFR1 mutant receptor activation	0.75
REACTOME_SIGNALING_BY_FGFR3_MUTANTS	FGFR3 mutant receptor activation	0.75
REACTOME_SIGNALING_BY_FGFR_MUTANTS	Signaling by FGFR in disease	0.75
REACTOME_UNFOLDED_PROTEIN_RESPONSE	Unfolded Protein Response (UPR)	0.75
REACTOME_SYNTHESIS_SECRETION_AND_INACTIVATION_OF_GLP1	Synthesis, secretion, and inactivation of Glucagon-like Peptide-1 (GLP-1)	0.75
REACTOME_REGULATION_OF_MRNA_STABILITY_BY_PROTEINS_THAT_BIND_AU_RICH_ELEMENTS	Regulation of mRNA stability by proteins that bind AU-rich elements	0.75
REACTOME_NUCLEOTIDE_BINDING_DOMAIN_LEUCINE_RICH_REPEAT_CONTAINING_RECEPTOR_NLR_SIGNALING_PATHWAYS	Nucleotide-binding domain, leucine rich repeat containing receptor (NLR) signaling pathways	0.75
REACTOME_APOPTOTIC_EXECUTION_PHASE	Apoptotic execution  phase	0.75
REACTOME_TGF_BETA_RECEPTOR_SIGNALING_IN_EMT_EPITHELIAL_TO_MESENCHYMAL_TRANSITION	TGF-beta receptor signaling in EMT (epithelial to mesenchymal transition)	0.7272727273
REACTOME_TRAF6_MEDIATED_IRF7_ACTIVATION_IN_TLR7_8_OR_9_SIGNALING	TRAF6 mediated IRF7 activation in TLR7/8 or 9 signaling	0.7272727273
REACTOME_G_BETA_GAMMA_SIGNALLING_THROUGH_PLC_BETA	G beta:gamma signalling through PLC beta	0.7142857143
REACTOME_JNK_C_JUN_KINASES_PHOSPHORYLATION_AND_ACTIVATION_MEDIATED_BY_ACTIVATED_HUMAN_TAK1	JNK (c-Jun kinases) phosphorylation and  activation mediated by activated human TAK1	0.7142857143
REACTOME_SYNTHESIS_OF_BILE_ACIDS_AND_BILE_SALTS_VIA_7ALPHA_HYDROXYCHOLESTEROL	Synthesis of bile acids and bile salts via 7alpha-hydroxycholesterol	0.7
REACTOME_SYNTHESIS_OF_BILE_ACIDS_AND_BILE_SALTS_VIA_24_HYDROXYCHOLESTEROL	Synthesis of bile acids and bile salts via 24-hydroxycholesterol	0.7
REACTOME_ASSOCIATION_OF_LICENSING_FACTORS_WITH_THE_PRE_REPLICATIVE_COMPLEX	Association of licensing factors with the pre-replicative complex	0.7
REACTOME_ASSOCIATION_OF_TRIC_CCT_WITH_TARGET_PROTEINS_DURING_BIOSYNTHESIS	Association of TriC/CCT with target proteins during biosynthesis	0.7
REACTOME_ACTIVATION_OF_NMDA_RECEPTOR_UPON_GLUTAMATE_BINDING_AND_POSTSYNAPTIC_EVENTS	Activation of NMDA receptor and postsynaptic events	0.7
REACTOME_DEPOSITION_OF_NEW_CENPA_CONTAINING_NUCLEOSOMES_AT_THE_CENTROMERE	Deposition of new CENPA-containing nucleosomes at the centromere	0.7
REACTOME_INHIBITION_OF_REPLICATION_INITIATION_OF_DAMAGED_DNA_BY_RB1_E2F1	Inhibition of replication initiation of damaged DNA by RB1/E2F1	0.7
REACTOME_BIOSYNTHESIS_OF_THE_N_GLYCAN_PRECURSOR_DOLICHOL_LIPID_LINKED_OLIGOSACCHARIDE_LLO_AND_TRANSFER_TO_A_NASCENT_PROTEIN	Biosynthesis of the N-glycan precursor (dolichol lipid-linked oligosaccharide, LLO) and transfer to a nascent protein	0.6842105263
REACTOME_RNA_POL_I_TRANSCRIPTION_TERMINATION	RNA Polymerase I Transcription Termination	0.6666666667
REACTOME_TCA_CYCLE_AND_RESPIRATORY_ELECTRON_TRANSPORT	The citric acid (TCA) cycle and respiratory electron transport	0.6666666667
REACTOME_ABCA_TRANSPORTERS_IN_LIPID_HOMEOSTASIS	ABC transporters in lipid homeostasis	0.6666666667
REACTOME_NEGATIVE_REGULATION_OF_FGFR_SIGNALING	Negative regulation of FGFR1 signaling///Negative regulation of FGFR2 signaling///Negative regulation of FGFR3 signaling///Negative regulation of FGFR4 signaling	0.6666666667
REACTOME_REGULATION_OF_HYPOXIA_INDUCIBLE_FACTOR_HIF_BY_OXYGEN	Regulation of Hypoxia-inducible Factor (HIF) by oxygen	0.6666666667
REACTOME_GASTRIN_CREB_SIGNALLING_PATHWAY_VIA_PKC_AND_MAPK	Gastrin-CREB signalling pathway via PKC and MAPK	0.6666666667
REACTOME_CYCLIN_E_ASSOCIATED_EVENTS_DURING_G1_S_TRANSITION_	Cyclin E associated events during G1/S transition	0.6666666667
REACTOME_MRNA_PROCESSING	mRNA 3'-end processing	0.6666666667
REACTOME_FORMATION_OF_TUBULIN_FOLDING_INTERMEDIATES_BY_CCT_TRIC	Formation of tubulin folding intermediates by CCT/TriC	0.6666666667
REACTOME_REGULATION_OF_INSULIN_SECRETION_BY_ACETYLCHOLINE	Regulation of insulin secretion	0.6666666667
REACTOME_TRAFFICKING_OF_GLUR2_CONTAINING_AMPA_RECEPTORS	Trafficking of AMPA receptors	0.6666666667
REACTOME_SEMA4D_INDUCED_CELL_MIGRATION_AND_GROWTH_CONE_COLLAPSE	Sema4D induced cell migration and growth-cone collapse	0.6666666667
REACTOME_SEMA3A_PLEXIN_REPULSION_SIGNALING_BY_INHIBITING_INTEGRIN_ADHESION	SEMA3A-Plexin repulsion signaling by inhibiting Integrin adhesion	0.6666666667
REACTOME_DOWNSTREAM_SIGNALING_OF_ACTIVATED_FGFR	Downstream signaling of activated FGFR1///Downstream signaling of activated FGFR2///Downstream signaling of activated FGFR3///Downstream signaling of activated FGFR4	0.6666666667
REACTOME_ENERGY_DEPENDENT_REGULATION_OF_MTOR_BY_LKB1_AMPK	Energy dependent regulation of mTOR by LKB1-AMPK	0.6666666667
REACTOME_RNA_POL_I_PROMOTER_OPENING	RNA Polymerase I Promoter Opening	0.6666666667
REACTOME_SYNTHESIS_SECRETION_AND_INACTIVATION_OF_GIP	Synthesis, secretion, and inactivation of Glucose-dependent Insulinotropic Polypeptide (GIP)	0.6666666667
REACTOME_INHIBITION_OF_VOLTAGE_GATED_CA2_CHANNELS_VIA_GBETA_GAMMA_SUBUNITS	Inhibition  of voltage gated Ca2+ channels via Gbeta/gamma subunits	0.6666666667
REACTOME_NEP_NS2_INTERACTS_WITH_THE_CELLULAR_EXPORT_MACHINERY	NEP/NS2 Interacts with the Cellular Export Machinery	0.6666666667
REACTOME_RNA_POL_III_TRANSCRIPTION_TERMINATION	RNA Polymerase III Transcription Termination	0.6666666667
REACTOME_RNA_POL_III_CHAIN_ELONGATION	RNA Polymerase III Chain Elongation	0.6666666667
REACTOME_REMOVAL_OF_THE_FLAP_INTERMEDIATE_FROM_THE_C_STRAND	Removal of the Flap Intermediate from the C-strand	0.6666666667
REACTOME_FGFR_LIGAND_BINDING_AND_ACTIVATION	FGFR1 ligand binding and activation///FGFR1b ligand binding and activation///FGFR1c ligand binding and activation///FGFR2 ligand binding and activation///FGFR2b ligand binding and activation///FGFR2c ligand binding and activation///FGFR3 ligand binding and activation///FGFR3b ligand binding and activation///FGFR3c ligand binding and activation///FGFR4 ligand binding and activation	0.6666666667
REACTOME_RNA_POL_I_TRANSCRIPTION_INITIATION	RNA Polymerase I Transcription Initiation	0.6666666667
REACTOME_CROSS_PRESENTATION_OF_SOLUBLE_EXOGENOUS_ANTIGENS_ENDOSOMES	Cross-presentation of soluble exogenous antigens (endosomes)	0.625
REACTOME_SRP_DEPENDENT_COTRANSLATIONAL_PROTEIN_TARGETING_TO_MEMBRANE	SRP-dependent cotranslational protein targeting to membrane	0.625
REACTOME_ACTIVATION_OF_NF_KAPPAB_IN_B_CELLS	Activation of NF-kappaB in B cells///Activation of RAS in B cells	0.625
REACTOME_YAP1_AND_WWTR1_TAZ_STIMULATED_GENE_EXPRESSION	YAP1- and WWTR1 (TAZ)-stimulated gene expression	0.625
REACTOME_CDK_MEDIATED_PHOSPHORYLATION_AND_REMOVAL_OF_CDC6	CDK-mediated phosphorylation and removal of Cdc6	0.625
REACTOME_NEGATIVE_REGULATION_OF_THE_PI3K_AKT_NETWORK	Negative regulation of the PI3K/AKT network	0.625
REACTOME_TRANSLOCATION_OF_ZAP_70_TO_IMMUNOLOGICAL_SYNAPSE	Translocation of ZAP-70 to Immunological synapse	0.625
REACTOME_CDC6_ASSOCIATION_WITH_THE_ORC_ORIGIN_COMPLEX	CDC6 association with the ORC:origin complex	0.625
REACTOME_SYNTHESIS_OF_SUBSTRATES_IN_N_GLYCAN_BIOSYTHESIS	Synthesis of substrates in N-glycan biosythesis	0.625
REACTOME_FORMATION_OF_INCISION_COMPLEX_IN_GG_NER	Formation of Incision Complex in GG-NER	0.625
REACTOME_APC_C_CDH1_MEDIATED_DEGRADATION_OF_CDC20_AND_OTHER_APC_C_CDH1_TARGETED_PROTEINS_IN_LATE_MITOSIS_EARLY_G1	APC/C:Cdh1 mediated degradation of Cdc20 and other APC/C:Cdh1 targeted proteins in late mitosis/early G1	0.6111111111
REACTOME_EXTRINSIC_PATHWAY_FOR_APOPTOSIS	Regulation of necroptotic cell death	0.6
REACTOME_METABOLISM_OF_NON_CODING_RNA	Metabolism of RNA	0.6
REACTOME_SIGNALING_BY_CONSTITUTIVELY_ACTIVE_EGFR	Signaling by EGFR	0.6
REACTOME_RORA_ACTIVATES_CIRCADIAN_EXPRESSION	RORA activates gene expression	0.6
REACTOME_CHONDROITIN_SULFATE_DERMATAN_SULFATE_METABOLISM	Chondroitin sulfate/dermatan sulfate metabolism	0.6
REACTOME_RNA_POL_I_TRANSCRIPTION	RNA Polymerase I Transcription	0.6
REACTOME_RNA_POL_II_TRANSCRIPTION	RNA Polymerase II Transcription	0.6
REACTOME_RNA_POL_III_TRANSCRIPTION	RNA Polymerase III Transcription	0.6
REACTOME_PREFOLDIN_MEDIATED_TRANSFER_OF_SUBSTRATE_TO_CCT_TRIC	Prefoldin mediated transfer of substrate  to CCT/TriC	0.6
REACTOME_PERK_REGULATED_GENE_EXPRESSION	PERK regulates gene expression	0.6
REACTOME_METABOLISM_OF_LIPIDS_AND_LIPOPROTEINS	Metabolism of lipids	0.6
REACTOME_ORGANIC_CATION_ANION_ZWITTERION_TRANSPORT	Organic cation transport	0.6
REACTOME_IL_RECEPTOR_SHC_SIGNALING	Interleukin receptor SHC signaling	0.6
REACTOME_LIGAND_GATED_ION_CHANNEL_TRANSPORT	Ion channel transport	0.6
REACTOME_ACTIVATION_OF_THE_PRE_REPLICATIVE_COMPLEX	Activation of the pre-replicative complex	0.5714285714
REACTOME_ANTIVIRAL_MECHANISM_BY_IFN_STIMULATED_GENES	Antiviral mechanism by IFN-stimulated genes	0.5714285714
REACTOME_DOWNREGULATION_OF_TGF_BETA_RECEPTOR_SIGNALING	Downregulation of TGF-beta receptor signaling	0.5714285714
REACTOME_TGF_BETA_RECEPTOR_SIGNALING_ACTIVATES_SMADS	TGF-beta receptor signaling activates SMADs	0.5714285714
REACTOME_CASPASE_MEDIATED_CLEAVAGE_OF_CYTOSKELETAL_PROTEINS	Caspase-mediated cleavage of cytoskeletal proteins	0.5714285714
REACTOME_P53_DEPENDENT_G1_DNA_DAMAGE_RESPONSE	p53-Dependent G1 DNA Damage Response	0.5714285714
REACTOME_PROCESSING_OF_CAPPED_INTRONLESS_PRE_MRNA	Processing of Capped Intronless Pre-mRNA	0.5714285714
REACTOME_NCAM_SIGNALING_FOR_NEURITE_OUT_GROWTH	NCAM signaling for neurite out-growth	0.5714285714
REACTOME_CLASS_B_2_SECRETIN_FAMILY_RECEPTORS	Class B/2 (Secretin family receptors)	0.5714285714
REACTOME_G_BETA_GAMMA_SIGNALLING_THROUGH_PI3KGAMMA	G beta:gamma signalling through PI3Kgamma	0.5714285714
REACTOME_ASSEMBLY_OF_THE_PRE_REPLICATIVE_COMPLEX	Assembly of the pre-replicative complex	0.5714285714
REACTOME_ION_TRANSPORT_BY_P_TYPE_ATPASES	Ion transport by P-type ATPases	0.5714285714
REACTOME_AUTODEGRADATION_OF_CDH1_BY_CDH1_APC_C	Autodegradation of Cdh1 by Cdh1:APC/C	0.5714285714
REACTOME_SIGNALING_BY_TGF_BETA_RECEPTOR_COMPLEX	Signaling by TGF-beta Receptor Complex	0.5714285714
REACTOME_APC_CDC20_MEDIATED_DEGRADATION_OF_NEK2A	APC-Cdc20 mediated degradation of Nek2A	0.5714285714
REACTOME_CDT1_ASSOCIATION_WITH_THE_CDC6_ORC_ORIGIN_COMPLEX	CDT1 association with the CDC6:ORC:origin complex	0.5555555556
REACTOME_APC_C_CDC20_MEDIATED_DEGRADATION_OF_MITOTIC_PROTEINS	APC/C:Cdc20 mediated degradation of mitotic proteins	0.5555555556
REACTOME_APC_C_CDC20_MEDIATED_DEGRADATION_OF_CYCLIN_B	APC/C:Cdc20 mediated degradation of Cyclin B	0.5555555556
REACTOME_GRB2_SOS_PROVIDES_LINKAGE_TO_MAPK_SIGNALING_FOR_INTERGRINS_	GRB2:SOS provides linkage to MAPK signaling for Integrins	0.5454545455
REACTOME_RNA_POL_II_TRANSCRIPTION_PRE_INITIATION_AND_PROMOTER_OPENING	RNA Polymerase II Transcription Pre-Initiation And Promoter Opening	0.5454545455
REACTOME_PROCESSING_OF_INTRONLESS_PRE_MRNAS	Processing of Intronless Pre-mRNAs	0.5
REACTOME_METABOLISM_OF_STEROID_HORMONES_AND_VITAMINS_A_AND_D	Metabolism of steroid hormones	0.5
REACTOME_SIGNALLING_BY_NGF	Signaling by NGF	0.5
REACTOME_CTNNB1_PHOSPHORYLATION_CASCADE	Beta-catenin phosphorylation cascade	0.5
REACTOME_TRANS_GOLGI_NETWORK_VESICLE_BUDDING	trans-Golgi Network Vesicle Budding	0.5
REACTOME_O_LINKED_GLYCOSYLATION_OF_MUCINS	O-linked glycosylation of mucins	0.5
REACTOME_TERMINATION_OF_O_GLYCAN_BIOSYNTHESIS	Termination of O-glycan biosynthesis	0.5
REACTOME_PRE_NOTCH_TRANSCRIPTION_AND_TRANSLATION	Pre-NOTCH Transcription and Translation	0.5
REACTOME_PRE_NOTCH_EXPRESSION_AND_PROCESSING	Pre-NOTCH Expression and Processing	0.5
REACTOME_SIGNALING_BY_THE_B_CELL_RECEPTOR_BCR	Downstream signaling events of B Cell Receptor (BCR)	0.5
REACTOME_PRE_NOTCH_PROCESSING_IN_GOLGI	Pre-NOTCH Processing in Golgi	0.5
REACTOME_TRANSCRIPTIONAL_ACTIVITY_OF_SMAD2_SMAD3_SMAD4_HETEROTRIMER	Transcriptional activity of SMAD2/SMAD3:SMAD4 heterotrimer	0.5
REACTOME_DOWNREGULATION_OF_SMAD2_3_SMAD4_TRANSCRIPTIONAL_ACTIVITY	Downregulation of SMAD2/3:SMAD4 transcriptional activity	0.5
REACTOME_ALPHA_LINOLENIC_ACID_ALA_METABOLISM	alpha-linolenic acid (ALA) metabolism	0.5
REACTOME_VEGF_LIGAND_RECEPTOR_INTERACTIONS	VEGF ligand-receptor interactions	XXX
REACTOME_SLBP_DEPENDENT_PROCESSING_OF_REPLICATION_DEPENDENT_HISTONE_PRE_MRNAS	SLBP Dependent Processing of Replication-Dependent Histone Pre-mRNAs	0.5
REACTOME_REGULATION_OF_BETA_CELL_DEVELOPMENT	Regulation of beta-cell development	0.5
REACTOME_P75_NTR_RECEPTOR_MEDIATED_SIGNALLING	p75 NTR receptor-mediated signalling	0.5
REACTOME_MITOCHONDRIAL_FATTY_ACID_BETA_OXIDATION	Mitochondrial Fatty Acid Beta-Oxidation	0.5
REACTOME_CLASS_A1_RHODOPSIN_LIKE_RECEPTORS	Class A/1 (Rhodopsin-like receptors)	0.5
REACTOME_ABC_FAMILY_PROTEINS_MEDIATED_TRANSPORT	ABC-family proteins mediated transport	0.5
REACTOME_PKA_MEDIATED_PHOSPHORYLATION_OF_CREB	PKA-mediated phosphorylation of CREB	0.5
REACTOME_INSULIN_SYNTHESIS_AND_PROCESSING	Insulin processing	0.5
REACTOME_POST_CHAPERONIN_TUBULIN_FOLDING_PATHWAY	Post-chaperonin tubulin folding pathway	0.5
REACTOME_METABOLISM_OF_NUCLEOTIDES	Nucleotide metabolism	0.5
REACTOME_MRNA_SPLICING_MINOR_PATHWAY	mRNA Splicing	0.5
REACTOME_TRANSCRIPTION	Generic Transcription Pathway	0.5
REACTOME_REGULATION_OF_THE_FANCONI_ANEMIA_PATHWAY	Fanconi Anemia Pathway	0.5
REACTOME_REGULATION_OF_INSULIN_SECRETION_BY_GLUCAGON_LIKE_PEPTIDE1	Glucagon-like Peptide-1 (GLP1) regulates insulin secretion	0.5
REACTOME_G_ALPHA1213_SIGNALLING_EVENTS	G alpha (12/13) signalling events	0.5
REACTOME_FACILITATIVE_NA_INDEPENDENT_GLUCOSE_TRANSPORTERS	Facilitative Na+-independent glucose transporters	0.5
REACTOME_CD28_DEPENDENT_PI3K_AKT_SIGNALING	CD28 dependent PI3K/Akt signaling	0.5
REACTOME_BRANCHED_CHAIN_AMINO_ACID_CATABOLISM	Branched-chain amino acid catabolism	0.5
REACTOME_NA_CL_DEPENDENT_NEUROTRANSMITTER_TRANSPORTERS	Na+/Cl- dependent neurotransmitter transporters	0.5
REACTOME_DOUBLE_STRAND_BREAK_REPAIR	DNA Double Strand Break Response	0.5
REACTOME_METABOLISM_OF_MRNA	Metabolism of RNA	0.5
REACTOME_SIGNALING_BY_ILS	Signaling by Interleukins	0.5
REACTOME_N_GLYCAN_TRIMMING_IN_THE_ER_AND_CALNEXIN_CALRETICULIN_CYCLE	N-glycan trimming in the ER and Calnexin/Calreticulin cycle	0.5
REACTOME_TRAF3_DEPENDENT_IRF_ACTIVATION_PATHWAY	TRAF3-dependent IRF activation pathway	0.5
REACTOME_INTERFERON_ALPHA_BETA_SIGNALING	Interferon Signaling	0.5
REACTOME_NEGATIVE_REGULATORS_OF_RIG_I_MDA5_SIGNALING	Negative regulators of RIG-I/MDA5 signaling	0.5
REACTOME_SYNTHESIS_OF_VERY_LONG_CHAIN_FATTY_ACYL_COAS	Beta-oxidation of very long chain fatty acids	0.5
REACTOME_PKB_MEDIATED_EVENTS	PKB-mediated events	0.5
REACTOME_METABOLISM_OF_CARBOHYDRATES	Carbohydrate metabolism	0.5
REACTOME_PURINE_METABOLISM	Nucleotide metabolism	0.5
REACTOME_SCF_BETA_TRCP_MEDIATED_DEGRADATION_OF_EMI1	SCF-beta-TrCP mediated degradation of Emi1	0.5
REACTOME_CONVERSION_FROM_APC_C_CDC20_TO_APC_C_CDH1_IN_LATE_ANAPHASE	Conversion from APC/C:Cdc20 to APC/C:Cdh1 in late anaphase	0.5
REACTOME_PHOSPHORYLATION_OF_THE_APC_C	Phosphorylation of the APC/C	0.5
REACTOME_PHASE_II_CONJUGATION	Phase II - Conjugation of compounds	0.5
REACTOME_ACTIVATION_OF_BH3_ONLY_PROTEINS	Activation of BH3-only proteins	0.5
REACTOME_G2_M_DNA_DAMAGE_CHECKPOINT	G2/M DNA damage checkpoint	0.5
REACTOME_METABOLISM_OF_PORPHYRINS	Porphyrin metabolism	0.5
REACTOME_VIF_MEDIATED_DEGRADATION_OF_APOBEC3G	Vif-mediated degradation of APOBEC3G	0.5
REACTOME_PYRIMIDINE_METABOLISM	Pyrimidine biosynthesis///Pyrimidine catabolism///Pyrimidine salvage 	0.5
REACTOME_GAMMA_CARBOXYLATION_TRANSPORT_AND_AMINO_TERMINAL_CLEAVAGE_OF_PROTEINS	Gamma-carboxylation, transport, and amino-terminal cleavage of proteins	0.4545454545
REACTOME_OXYGEN_DEPENDENT_PROLINE_HYDROXYLATION_OF_HYPOXIA_INDUCIBLE_FACTOR_ALPHA	Oxygen-dependent proline hydroxylation of Hypoxia-inducible Factor Alpha	0.4545454545
REACTOME_CYCLIN_A_B1_ASSOCIATED_EVENTS_DURING_G2_M_TRANSITION	Cyclin A/B1 associated events during G2/M transition///Cyclin E associated events during G1/S transition	0.4545454545
REACTOME_TRANSPORT_OF_INORGANIC_CATIONS_ANIONS_AND_AMINO_ACIDS_OLIGOPEPTIDES	Transport of inorganic cations/anions and amino acids/oligopeptides	0.4545454545
REACTOME_ACTIVATION_OF_IRF3_IRF7_MEDIATED_BY_TBK1_IKK_EPSILON	Activation of IRF3/IRF7 mediated by TBK1/IKK epsilon	0.4545454545
REACTOME_RIP_MEDIATED_NFKB_ACTIVATION_VIA_DAI	RIP-mediated NFkB activation via ZBP1	0.4285714286
REACTOME_SMAD2_SMAD3_SMAD4_HETEROTRIMER_REGULATES_TRANSCRIPTION	SMAD2/SMAD3:SMAD4 heterotrimer regulates transcription	0.4285714286
REACTOME_PHASE1_FUNCTIONALIZATION_OF_COMPOUNDS	Phase I - Functionalization of compounds	0.4285714286
REACTOME_G_PROTEIN_ACTIVATION	Activation of G protein gated Potassium channels	0.4285714286
REACTOME_ACTIVATION_OF_CHAPERONE_GENES_BY_XBP1S	XBP1(S) activates chaperone genes	0.4285714286
REACTOME_ADP_SIGNALLING_THROUGH_P2RY1	ADP signalling through P2Y purinoceptor 1	0.4285714286
REACTOME_ADP_SIGNALLING_THROUGH_P2RY12	ADP signalling through P2Y purinoceptor 12	0.4285714286
REACTOME_REGULATION_OF_AMPK_ACTIVITY_VIA_LKB1	Energy dependent regulation of mTOR by LKB1-AMPK	0.4285714286
REACTOME_RNA_POL_II_PRE_TRANSCRIPTION_EVENTS	RNA Polymerase II Transcription	0.4285714286
REACTOME_FATTY_ACID_TRIACYLGLYCEROL_AND_KETONE_BODY_METABOLISM	Fatty acid metabolism///Ketone body metabolism	0.4285714286
REACTOME_RAF_MAP_KINASE_CASCADE	RAF/MAP kinase cascade	0.4285714286
REACTOME_COPI_MEDIATED_TRANSPORT	COPI-mediated anterograde transport	0.4
REACTOME_SIGNALING_BY_SCF_KIT	Signaling by SCF-KIT	0.4
REACTOME_ANTIGEN_PROCESSING_CROSS_PRESENTATION	Antigen processing-Cross presentation	0.4
REACTOME_KERATAN_SULFATE_KERATIN_METABOLISM	Keratan sulfate/keratin metabolism	0.4
REACTOME_FATTY_ACYL_COA_BIOSYNTHESIS	Fatty acyl-CoA biosynthesis	0.4
REACTOME_E2F_ENABLED_INHIBITION_OF_PRE_REPLICATION_COMPLEX_FORMATION	E2F-enabled inhibition of pre-replication complex formation	0.4
REACTOME_PEPTIDE_LIGAND_BINDING_RECEPTORS	Peptide ligand-binding receptors	0.4
REACTOME_NOTCH_HLH_TRANSCRIPTION_PATHWAY	Notch-HLH transcription pathway	0.4
REACTOME_HORMONE_LIGAND_BINDING_RECEPTORS	Hormone ligand-binding receptors	0.4
REACTOME_GPVI_MEDIATED_ACTIVATION_CASCADE	GPVI-mediated activation cascade	0.4
REACTOME_GLUCAGON_TYPE_LIGAND_RECEPTORS	Glucagon-type ligand receptors	0.4
REACTOME_MRNA_3_END_PROCESSING	mRNA 3'-end processing	0.4
REACTOME_POST_TRANSLATIONAL_MODIFICATION_SYNTHESIS_OF_GPI_ANCHORED_PROTEINS	Post-translational modification: synthesis of GPI-anchored proteins	0.4
REACTOME_SLC_MEDIATED_TRANSMEMBRANE_TRANSPORT	SLC-mediated transmembrane transport	0.4
REACTOME_DEADENYLATION_DEPENDENT_MRNA_DECAY	Deadenylation of mRNA///Deadenylation-dependent mRNA decay	0.4
REACTOME_CELL_EXTRACELLULAR_MATRIX_INTERACTIONS	Cell-extracellular matrix interactions	0.4
REACTOME_MITOTIC_G1_G1_S_PHASES	Mitotic G1-G1/S phases	0.4
REACTOME_MITOTIC_M_M_G1_PHASES	Mitotic Metaphase and Anaphase	0.4
REACTOME_MITOTIC_G2_G2_M_PHASES	Mitotic G2-G2/M phases	0.4
REACTOME_POST_TRANSLATIONAL_PROTEIN_MODIFICATION	Post-translational protein modification	0.4
REACTOME_ASPARAGINE_N_LINKED_GLYCOSYLATION	Asparagine N-linked glycosylation	0.4
REACTOME_AQUAPORIN_MEDIATED_TRANSPORT	Aquaporin-mediated transport	0.4
REACTOME_NFKB_ACTIVATION_THROUGH_FADD_RIP1_PATHWAY_MEDIATED_BY_CASPASE_8_AND10	NF-kB activation through FADD/RIP-1 pathway mediated by caspase-8 and -10	0.4
REACTOME_DESTABILIZATION_OF_MRNA_BY_AUF1_HNRNP_D0	AUF1 (hnRNP D0) binds and destabilizes mRNA	0.4
REACTOME_NOD1_2_SIGNALING_PATHWAY	NOD1/2 Signaling Pathway	0.4
REACTOME_REGULATION_OF_INSULIN_LIKE_GROWTH_FACTOR_IGF_ACTIVITY_BY_INSULIN_LIKE_GROWTH_FACTOR_BINDING_PROTEINS_IGFBPS	Regulation of IGF Activity by IGFBP	0.3846153846
REACTOME_BMAL1_CLOCK_NPAS2_ACTIVATES_CIRCADIAN_EXPRESSION	BMAL1:CLOCK,NPAS2 activates circadian gene expression	0.375
REACTOME_P53_INDEPENDENT_G1_S_DNA_DAMAGE_CHECKPOINT	G2/M DNA damage checkpoint	0.375
REACTOME_METABOLISM_OF_AMINO_ACIDS_AND_DERIVATIVES	Amino acid and derivative metabolism	0.375
REACTOME_BASE_FREE_SUGAR_PHOSPHATE_REMOVAL_VIA_THE_SINGLE_NUCLEOTIDE_REPLACEMENT_PATHWAY	Abasic sugar-phosphate removal via the single-nucleotide replacement pathway	0.375
REACTOME_INHIBITION_OF_INSULIN_SECRETION_BY_ADRENALINE_NORADRENALINE	Adrenaline,noradrenaline inhibits insulin secretion	0.375
REACTOME_ACTIVATION_OF_GENES_BY_ATF4	ATF4 activates genes	0.375
REACTOME_G_PROTEIN_BETA_GAMMA_SIGNALLING	G beta:gamma signalling through PLC beta	0.375
REACTOME_RNA_POL_I_RNA_POL_III_AND_MITOCHONDRIAL_TRANSCRIPTION	RNA Polymerase I Transcription	0.375
REACTOME_ROLE_OF_DCC_IN_REGULATING_APOPTOSIS	Ligand-independent caspase activation via DCC	0.375
REACTOME_SCFSKP2_MEDIATED_DEGRADATION_OF_P27_P21	SCF(Skp2)-mediated degradation of p27/p21	0.375
REACTOME_N_GLYCAN_ANTENNAE_ELONGATION_IN_THE_MEDIAL_TRANS_GOLGI	N-glycan antennae elongation in the medial/trans-Golgi	0.3636363636
REACTOME_NFKB_AND_MAP_KINASES_ACTIVATION_MEDIATED_BY_TLR4_SIGNALING_REPERTOIRE	TRAF6 Mediated Induction of proinflammatory cytokines	0.3529411765
REACTOME_TRIF_MEDIATED_TLR3_SIGNALING	TRIF-mediated TLR3/TLR4 signaling	0.3333333333
REACTOME_CELL_CELL_COMMUNICATION	Cell-Cell communication	0.3333333333
REACTOME_PROCESSING_OF_CAPPED_INTRON_CONTAINING_PRE_MRNA	Processing of Capped Intron-Containing Pre-mRNA	0.3333333333
REACTOME_HDL_MEDIATED_LIPID_TRANSPORT	HDL remodeling	0.3333333333
REACTOME_COMMON_PATHWAY	Common Pathway of Fibrin Clot Formation	0.3333333333
REACTOME_NEUROTRANSMITTER_RECEPTOR_BINDING_AND_DOWNSTREAM_TRANSMISSION_IN_THE_POSTSYNAPTIC_CELL	Neurotransmitter receptors and postsynaptic signal transmission	0.3333333333
REACTOME_POL_SWITCHING	Polymerase switching	0.3333333333
REACTOME_CLASS_C_3_METABOTROPIC_GLUTAMATE_PHEROMONE_RECEPTORS	Class C/3 (Metabotropic glutamate/pheromone receptors)	0.3333333333
REACTOME_ACTIVATION_OF_CHAPERONES_BY_ATF6_ALPHA	ATF6 (ATF6-alpha) activates chaperones	0.3333333333
REACTOME_ACTIVATION_OF_CHAPERONE_GENES_BY_ATF6_ALPHA	ATF6 (ATF6-alpha) activates chaperone genes	0.3333333333
REACTOME_PHOSPHOLIPASE_C_MEDIATED_CASCADE	Phospholipase C-mediated cascade; FGFR2///Phospholipase C-mediated cascade; FGFR3///Phospholipase C-mediated cascade; FGFR4///Phospholipase C-mediated cascade: FGFR1	0.3333333333
REACTOME_IL1_SIGNALING	Interleukin-1 signaling signaling///Tie2 Signaling///TNF signaling	0.3333333333
REACTOME_IL_3_5_AND_GM_CSF_SIGNALING	Interleukin-3, 5 and GM-CSF signaling	0.3333333333
REACTOME_REGULATION_OF_WATER_BALANCE_BY_RENAL_AQUAPORINS	Vasopressin regulates renal water homeostasis via Aquaporins	0.3333333333
REACTOME_DESTABILIZATION_OF_MRNA_BY_BRF1	Butyrate Response Factor 1 (BRF1) binds and destabilizes mRNA	0.3333333333
REACTOME_DESTABILIZATION_OF_MRNA_BY_KSRP	KSRP (KHSRP) binds and destabilizes mRNA	0.3333333333
REACTOME_RIG_I_MDA5_MEDIATED_INDUCTION_OF_IFN_ALPHA_BETA_PATHWAYS	RIG-I/MDA5 mediated induction of IFN-alpha/beta pathways	0.3333333333
REACTOME_CHYLOMICRON_MEDIATED_LIPID_TRANSPORT	Chylomicron assembly	0.3333333333
REACTOME_TOLL_RECEPTOR_CASCADES	Toll Like Receptor TLR1:TLR2 Cascade///Toll Like Receptor TLR6:TLR2 Cascade	0.3333333333
REACTOME_PIP3_ACTIVATES_AKT_SIGNALING	Constitutive Signaling by AKT1 E17K in Cancer	0.3333333333
REACTOME_FORMATION_OF_TRANSCRIPTION_COUPLED_NER_TC_NER_REPAIR_COMPLEX	Formation of TC-NER Pre-Incision Complex	0.3
REACTOME_DESTABILIZATION_OF_MRNA_BY_TRISTETRAPROLIN_TTP	Tristetraprolin (TTP, ZFP36) binds and destabilizes mRNA	0.3
REACTOME_3_UTR_MEDIATED_TRANSLATIONAL_REGULATION	3' -UTR-mediated translational regulation	0.2857142857
REACTOME_PASSIVE_TRANSPORT_BY_AQUAPORINS	Transport of glycerol from adipocytes to the liver by Aquaporins	0.2857142857
REACTOME_CIRCADIAN_REPRESSION_OF_EXPRESSION_BY_REV_ERBA	NR1D1 (REV-ERBA) represses gene expression	0.2727272727
REACTOME_REPAIR_SYNTHESIS_FOR_GAP_FILLING_BY_DNA_POL_IN_TC_NER	Gap-filling DNA repair synthesis and ligation in TC-NER	0.2666666667
REACTOME_ENDOSOMAL_VACUOLAR_PATHWAY	Endosomal/Vacuolar pathway	0.25
REACTOME_ER_PHAGOSOME_PATHWAY	ER-Phagosome pathway	0.25
REACTOME_IL_7_SIGNALING	Interleukin-7 signaling	0.25
REACTOME_HS_GAG_DEGRADATION	HS-GAG degradation	0.25
REACTOME_CS_DS_DEGRADATION	CS/DS degradation	0.25
REACTOME_HS_GAG_BIOSYNTHESIS	HS-GAG biosynthesis biosynthesis	0.25
REACTOME_HEPARAN_SULFATE_HEPARIN_HS_GAG_METABOLISM	Heparan sulfate/heparin (HS-GAG) metabolism	0.25
REACTOME_PI3K_AKT_ACTIVATION	PI3K/AKT activation	0.25
REACTOME_REGULATORY_RNA_PATHWAYS	MicroRNA (miRNA) biogenesis	0.25
REACTOME_ERK_MAPK_TARGETS	ERK/MAPK targets	0.25
REACTOME_CA_DEPENDENT_EVENTS	Ca-dependent events	0.25
REACTOME_DARPP_32_EVENTS	DARPP-32 events	0.25
REACTOME_AMINE_DERIVED_HORMONES	Amine-derived hormones	0.25
REACTOME_M_G1_TRANSITION	M/G1 Transition	0.25
REACTOME_G1_S_TRANSITION	G1/S Transition	0.25
REACTOME_CD28_CO_STIMULATION	CD28 co-stimulation	0.25
REACTOME_FRS2_MEDIATED_CASCADE	Frs2-mediated activation	0.25
REACTOME_PI_3K_CASCADE	PI3K Cascade	0.25
REACTOME_SHC_MEDIATED_CASCADE	SHC-mediated cascade:FGFR1///SHC-mediated cascade:FGFR2///SHC-mediated cascade:FGFR3///SHC-mediated cascade:FGFR4	0.25
REACTOME_CALNEXIN_CALRETICULIN_CYCLE	Calnexin/calreticulin cycle	0.25
REACTOME_N_GLYCAN_ANTENNAE_ELONGATION	N-glycan antennae elongation in the medial/trans-Golgi	0.25
REACTOME_IL_2_SIGNALING	Interleukin-2 signaling	0.25
REACTOME_IL_6_SIGNALING	Interleukin-6 family signaling	0.25
REACTOME_SOS_MEDIATED_SIGNALLING	SOS-mediated signalling	0.25
REACTOME_SHC_MEDIATED_SIGNALLING	Interleukin receptor SHC signaling	0.25
REACTOME_MTORC1_MEDIATED_SIGNALLING	mTORC1-mediated signalling	0.25
REACTOME_G2_M_CHECKPOINTS	G2/M Checkpoints	0.25
REACTOME_SHC_RELATED_EVENTS	Signal attenuation	0.25
REACTOME_TRANSCRIPTION_COUPLED_NER_TC_NER	G1/S-Specific Transcription	0.2
REACTOME_G1_S_SPECIFIC_TRANSCRIPTION	G1/S-Specific Transcription	0.2
REACTOME_GLOBAL_GENOMIC_NER_GG_NER	Global Genome Nucleotide Excision Repair (GG-NER)	0.1111111111
REACTOME_HORMONE_SENSITIVE_LIPASE_HSL_MEDIATED_TRIACYLGLYCEROL_HYDROLYSIS	Triglyceride catabolism	0.1111111111
REACTOME_AMYLOIDS	Amyloid fiber formation	0
